8
IA niveau 1
HHV00000
00VHH0HH
00V0V000
00V0V0HH
HH00V0V0
0HH0V0V0
0V000000
0V000000
