8
H
HVV00000
HH000000
0HVV0000
00H00H00
00HVVH00
00000000
000VVH00
00000H00
